NO maps/textures/bricks.xpm
SO maps/textures/mud.xpm
WE maps/textures/dirt.xpm
EA maps/textures/coal.xpm

F 220,100,0
C 225,30,0

1111111111111111 1111111111
1000000000000001 1000000001
1000001111110001 1111111001
1000001000010001       1001
1000001111110001       1001
1000001 10110001       1001
1000001  1 10001       1001
1000001    11111 1111  1001
1000001          1001  1001
100000111111111111001111001
1000000000000000000N0000001
111111111111110000000000001
             10000000000001
             11111111111111
