NO     ./maps/textures/bricks.xpm   
SO   ./maps/textures/mud.xpm    
WE maps/textures/dirt.xpm
EA     ./maps/textures/coal.xpm   

F       40,       40,   40
C    50,  50 ,              175


                                
1       111111111111111111111111     
1       1000000000110000000000001  
1       1011000001110000000000001
1       1001000000000000000000001  
111111111011000001110000000000001
100000000011000001110111111111101
1111011111  110111000000100011001 
11110111  111101 1010100100011101 
1100000011010101 1000000000011111        
10000000000000001100000010001    
10000000000000001101010010001 
11000001110101011111011110N001      
  110111 1110101 101111010001  
11111111 1111111 111 11111111  
 
    

   
                  
                  
    